NO imgs/CRATE_1D.xpm
SO imgs/DOOR_1A.xpm
WE imgs/DOOR_1E.xpm
EA imgs/DOOR_1E.xpm

C 225,30,0
F 220,100,0

11111111111111111111111111111111111111111111111111
10000000000000000000000000000000000000000000000001
10000000000000000000000000000000000000000000000001
10000000000000000000000000000000000000000000000001
10000111111111100000000000000000000000000000000001
10000100000000100000000000000000000000000000000001
10000100000000100000000000000000000000000000000001
10000100000000100000000000000001000000000000000001
10000111111111100000000000000001000000000000000001
10000000000000000000000000000001000000000000000001
10000000000000000000000000000001000000000000000001
10000000000000000000000000000001000000000000000001
10000000000000000000000000000001000000000000000001
10000000000000000000000000000001000000000000000001
10000000000000000000000000000001000000000000000001
10000000000000000000001111010000000000000000000001
10000000000000000000000000000000000000000000000001
10000000010000000000000000000000000000000000000001
10000000010000000000000000000000000000000000000001
10000000010000001111111000000000000000000000000001
10000000010000000011111110000000000000000000000001
10000000010000000000000000000000000000000000000001
10000000010000000000000000000000000000000000000001
10000000010000000000000000000000000000000000000001
10000000000000000000000000000000000000000000000001
10000000000000000111111110000000000000000000000001
10000000000000000000000000000000000000000000000001
10000000000000N00000000000000000000000000000000001
11111111111111111111111111111111111111111111111111
