NO ./imgs/62_snow-bricks-texture-seamless.xpm
SO ./imgs/62_snow-bricks-texture-seamless.xpm
WE ./imgs/63_snow-bricks-texture-seamless.xpm
EA ./imgs/63_snow-bricks-texture-seamless.xpm

C 225,30,0
F 220,100,0

11111111111111111111111111
10000000000000000000000001
10000000000000000000000001
10000100000000000000000001
10001111100000000000000001
10000000000000000000000001
10000000000010000000000001
10000000000000000000000001
10000000000000000000000001
10000000000N00000000000001
11111111111111111111111111